



#                        #                   
#j j                     #
#####                 C  #
#    L ec      c     ### #
#    #####   #####       #
#                     ce #
#                   ######
#           e L e        #
# C  c  L   #####  L    C#
##########################