



#                        #
#       sc               #
#      ###         cse   #     
# j j       cep    ###   # 
#           ###    pc    #
#                 ###    #
#                        #
#        e s      ps #e  #
#       ##### pc #########
##########################