





#                        #     
# j j     p c       psp  # 
#        soe  s   ###### #
#                        #
#            p c p       #
#            o    e      #
#       c     c    c     #
##########################