



#                        #                   
#j j                     #
#####                 C  #
#     ec      cL     ### #
#    #####   #####       #
#                     ce #
#                   ######
#           e L e        #
# C  c  L   #####  L    C#
##########################